#ODT    ranHex
ACTCGTAA	CTGCTTTGT
AAACGATA	CATGATCAT
TTACCTCG	GGGTAGCGT
GCCTGCAA	CCGAGAAAT
TGGTATAC	ACGGACTCT
CGTTCGAG	ACTTACGAT
TCTATTAC	TATTTAAGT
ATAAGCTC	ACCGTACGT
ATTCATGG	TATAGTCGT
ATCCGCGA	TGGGCATCT
ATCGCATA	TACCTAGAT
CCGTTCTA	GCTGCATGT
TGGCGCGC	GTCATATGT
TGTCTGAA	ATATTGGCT
CTGTCCCG	CTAAGGGAT
AATTTCTC	TCGTTTCGT
CGCGACTA	GAATAATGT
GGGATCGG	ACTGCGCAT
TTATTCTG	GCTTATAGT
AGGCGGCA	ATCATGCAT
ACGCCGGC	ACGTTAACT
TTGTCTTA	CCATCTTGT
TACGGTTA	CATAGCTAT
TTGGGAGA	GAGGTTGAT
TGCTTGGG	GCACTGACT
TAAATATC	TTCATCGCT
CACAATTG	GAAATTAGT
GTGCTAGC	AGGATTAAT
CGCCCGGA	AATAGAACT
GCTCGCGG	TCTTAATCT
CTTTGGTC	TAATACGCT
TTCCGATC	GTTTGTGAT
TTCGCTAC	CGAACGTCT
AGCGAAAC	GGTTCTTCT
AAATAGCA	GCAAATTCT
CGTCTAGG	GCTATGCGT
GCCGTGTA	CTACCCTAT
CGCTTAAA	GTGGGTTCT
GACCTTTC	GTCCGTAGT
GGTGGAGC	TGCGATCGT
TACTCGAA	TATCCGGGT
CATTTGGA	AGGTAATAT
GACGGGAC	CGTGGTTGT
GTCGCGCG	GACAAAGCT
GTTACGTA	GGGCGATGT
CTATTTCA	ATCTATAAT
ACTATATA	GCCCATGAT
TCACTTTA	CTGAAAGGT
